2,2,2,2,2,2,2,2,2,2,2,2,2,2,2,2
2,2,2,2,3,0,3,0,1,0,3,0,3,2,2,2
2,2,2,2,3,3,3,3,3,3,3,3,0,2,2,2
2,2,2,2,0,3,4,3,4,4,6,4,3,2,2,2
2,2,2,2,3,3,6,4,3,4,3,3,6,2,2,2
2,2,2,2,0,3,3,6,4,0,4,3,6,2,2,2
2,2,2,2,0,0,2,3,3,6,3,0,3,2,2,2
2,2,2,2,0,3,0,0,7,0,3,0,3,2,2,2
2,2,2,2,2,2,2,2,2,2,2,2,2,2,2,2