2,2,2,2,2,2,2,2,2,2,2,2,2,2,2,2
2,2,2,2,1,2,2,2,2,2,2,2,2,2,2,2
2,2,2,4,3,0,4,0,3,0,3,7,2,2,2,2
2,2,2,6,0,4,3,0,3,0,0,3,2,2,2,2
2,2,2,3,3,4,3,0,3,0,4,0,2,2,2,2
2,2,2,0,0,2,2,4,0,2,3,3,2,2,2,2
2,2,2,3,4,0,3,6,3,0,6,0,2,2,2,2
2,2,2,6,3,0,6,3,0,4,0,0,2,2,2,2
2,2,2,2,2,2,2,2,2,2,2,2,2,2,2,2