2,2,2,2,2,2,2,2,2,2,2,2,2,2,2,2
2,2,0,0,0,2,2,2,0,0,0,2,2,2,2,2
2,1,4,4,0,5,0,5,4,0,0,5,0,0,0,2
2,0,4,0,4,5,0,5,4,0,0,5,0,0,0,2
2,0,4,4,0,5,0,5,4,0,0,5,0,0,0,2
2,0,4,0,0,5,0,5,4,0,0,5,0,0,0,2
2,0,4,0,0,6,5,6,4,4,4,5,5,5,7,2
2,2,0,0,0,2,2,2,0,0,0,2,2,2,2,2
2,2,2,2,2,2,2,2,2,2,2,2,2,2,2,2