2,2,2,2,2,2,2,2,2,2,2,2,2,2,2,2
2,0,3,1,3,4,3,3,7,0,0,3,0,0,0,2
2,3,0,3,0,3,0,4,3,0,3,0,0,3,3,2
2,0,3,4,3,0,3,3,3,3,0,4,6,3,0,2
2,2,4,3,0,3,0,0,3,0,3,6,0,6,0,2
2,0,0,0,3,0,0,3,4,0,6,3,3,0,3,2
2,3,3,3,0,0,3,0,3,3,0,0,3,4,6,2
2,0,3,0,3,3,0,3,0,3,3,0,0,3,3,2
2,2,2,2,2,2,2,2,2,2,2,2,2,2,2,2