2,2,2,2,2,2,2,2,2,2,2,2,2,2,2,2
2,1,0,3,0,4,0,0,6,5,0,3,0,3,0,2
2,5,5,3,3,4,0,3,4,0,6,3,0,3,0,2
2,4,0,3,6,0,3,3,4,3,0,3,0,3,0,2
2,5,0,3,3,4,7,3,4,0,0,3,0,3,6,2
2,6,4,0,6,4,3,3,0,4,4,4,4,4,5,2
2,3,5,0,3,4,0,3,3,0,0,5,6,0,5,2
2,6,3,4,6,4,3,0,0,0,5,6,5,3,6,2
2,2,2,2,2,2,2,2,2,2,2,2,2,2,2,2
