2,2,2,2,2,2,2,2,2,2,2,2,2,2,2,2
2,2,2,1,2,2,2,2,2,2,2,2,2,2,2,2
2,2,0,0,6,7,0,3,4,6,3,4,0,0,2,2
2,2,0,2,3,4,3,0,4,0,0,4,0,3,2,2
2,2,3,3,6,4,0,0,3,0,0,3,0,0,2,2
2,2,4,4,6,3,3,0,3,0,3,3,4,0,2,2
2,2,6,3,3,3,0,3,2,3,6,3,0,0,2,2
2,2,0,4,6,3,0,4,6,3,0,0,3,0,2,2
2,2,2,2,2,2,2,2,2,2,2,2,2,2,2,2