2,2,2,2,2,2,2,2,2,2,2,2,2,2,2,2
2,2,2,2,2,2,2,2,2,2,2,2,2,2,2,2
2,2,1,2,2,2,2,2,2,2,2,2,2,2,2,2
2,4,3,0,0,0,3,0,0,0,4,0,0,3,0,2
2,0,0,4,0,3,4,3,0,0,3,0,0,3,7,2
2,0,0,0,0,0,3,0,0,0,3,0,0,3,0,2
2,2,2,2,2,2,2,2,2,2,2,2,2,2,2,2
2,2,2,2,2,2,2,2,2,2,2,2,2,2,2,2
2,2,2,2,2,2,2,2,2,2,2,2,2,2,2,2