2,2,2,2,2,2,2,2,2,2,2,2,2,2,2,2
2,2,0,3,0,0,0,3,0,0,3,3,3,0,0,2
2,2,0,3,3,0,0,3,0,3,0,0,0,3,0,2
2,2,0,3,0,3,0,3,0,3,0,0,0,3,0,2
2,2,0,3,0,3,0,3,0,3,0,0,0,3,0,2
2,1,0,3,0,0,3,3,0,3,0,0,0,3,0,2
2,2,0,3,0,0,0,3,0,0,3,3,3,0,7,2
2,2,2,2,2,2,2,2,2,2,2,2,2,2,2,2
2,2,2,2,2,2,2,2,2,2,2,2,2,2,2,2