2,2,2,2,2,2,2,2,2,2,2,2,2,2,2,2
2,2,0,0,0,2,2,2,0,0,0,2,2,2,2,2
2,0,3,3,0,5,0,5,0,3,3,5,0,5,0,2
2,0,3,0,3,5,0,5,3,0,0,5,6,5,0,2
2,1,3,3,0,5,0,5,0,3,0,5,5,5,0,2
2,0,3,0,0,5,0,5,0,0,3,5,6,5,0,2
2,0,3,0,0,6,5,6,3,3,0,5,0,5,7,2
2,2,2,2,2,2,2,2,0,0,0,2,2,2,2,2
2,2,2,2,2,2,2,2,2,2,2,2,2,2,2,2