2,2,2,2,2,2,2,2,2,2,2,2,2,2,2,2
2,2,2,2,2,2,2,2,2,2,2,2,2,1,2,2
2,0,3,0,0,0,3,0,4,0,3,0,4,3,4,2
2,0,3,0,4,0,6,0,0,3,0,0,3,4,0,2
2,2,2,2,3,4,3,4,0,4,2,2,2,0,6,2
2,0,0,4,3,6,0,3,0,3,0,0,4,3,3,2
2,3,0,3,0,2,2,2,2,2,2,3,3,6,4,2
2,6,3,6,3,0,0,0,7,0,0,0,0,3,6,2
2,2,2,2,2,2,2,2,2,2,2,2,2,2,2,2