2,2,2,2,2,2,2,2,2,2,2,2,2,2,2,2
2,2,2,2,2,2,0,3,0,2,2,2,2,2,2,2
2,2,2,2,2,1,0,3,0,0,2,2,2,2,2,2
2,2,2,2,0,0,0,3,0,0,0,2,2,2,2,2
2,2,2,2,6,4,4,2,0,0,6,2,2,2,2,2
2,2,2,2,0,0,0,0,0,0,0,2,2,2,2,2
2,2,2,2,2,0,0,0,0,7,2,2,2,2,2,2
2,2,2,2,2,2,0,6,0,2,2,2,2,2,2,2
2,2,2,2,2,2,2,2,2,2,2,2,2,2,2,2
2,2,2,2,2,2,2,2,2,2,2,2,2,2,2,2