2,2,2,2,2,2,2,2,2,2,2,2,2,2,2,2
2,2,2,2,2,2,2,2,1,2,2,2,2,2,2,2
2,0,3,0,3,0,3,3,4,4,4,0,0,3,2,2
2,3,0,3,4,3,3,0,3,6,0,0,3,3,2,2
2,3,3,0,3,0,3,0,0,3,0,0,3,0,2,2
2,0,3,7,0,3,4,0,0,3,3,3,0,3,2,2
2,3,3,0,3,0,3,3,0,0,0,3,0,3,2,2
2,2,2,2,2,2,2,2,2,2,2,2,2,2,2,2
2,2,2,2,2,2,2,2,2,2,2,2,2,2,2,2