2,2,2,2,2,2,2,2,2,2,2,2,2,2,2,2
2,2,2,2,2,2,2,2,2,2,2,2,2,1,2,2
2,0,3,0,3,0,2,0,0,3,0,2,0,3,0,2
2,0,0,0,4,0,2,0,0,4,2,0,2,0,4,2
2,2,0,3,3,3,6,0,3,4,0,3,0,0,0,2
2,0,3,0,4,0,2,0,0,4,3,0,3,4,3,2
2,0,0,0,3,3,2,0,0,2,0,3,0,3,0,2
2,2,7,2,2,2,2,2,2,2,2,2,2,2,2,2
2,2,2,2,2,2,2,2,2,2,2,2,2,2,2,2