2,2,2,2,2,2,2,2,2,2,2,2,2,2,2,2
2,2,2,0,0,0,0,0,0,0,0,0,0,0,2,2
2,2,0,0,0,0,0,0,0,0,0,0,0,0,2,2
2,0,3,3,3,3,3,0,3,3,3,3,3,0,2,2
2,3,3,4,0,6,3,3,3,4,6,6,3,3,2,2
2,0,3,4,6,6,3,0,3,4,0,6,3,0,2,2
2,0,0,3,3,3,0,2,0,3,3,3,0,0,2,2
2,2,7,0,0,0,2,2,2,0,0,0,0,1,2,2
2,2,2,2,2,2,2,2,2,2,2,2,2,2,2,2